Where was Khatchig Mouradian born?	Lebanon
Where was Jacob Henry Studer born?	Columbus
Where was John Stephen born?	Glasgow
Where was Georgina Willis born?	Australia
Where was Stanley Corrsin born?	Philadelphia
Where was Eduard Ender born?	Rome
Where was John Fisher born?	Glasgow
Where was Iago Dekanozishvili born?	Tbilisi
Where was Lucy Toulmin Smith born?	Boston
Where was George Osborn born?	Rochester
Where was Leslie Hofton born?	Sheffield
Where was Chiyoki Ikeda born?	Honolulu
Where was Geoffrey Nutter born?	Sacramento
Where was Eyolf Kleven born?	Copenhagen
Where was Marvano born?	Belgium
Where was Naïma Azough born?	Morocco
Where was Eugenia Popa born?	Bucharest
Where was Douglas P. Fry born?	Boston
Where was Hans Gefors born?	Stockholm
Where was Sohail Fazal born?	Lahore
Where was James Johnson born?	Virginia
Where was Håvard Rem born?	Oslo
Where was Hubert Schiffer born?	Germany
Where was Ivan Petch born?	Concord
Where was Guido Marzorati born?	Venice
Where was Sean Hickey born?	Detroit
Where was Hector de Castro born?	Constantinople
Where was Lloyd Goffe born?	Reading
Where was Alois Wachsman born?	Prague
Where was Martin Connor born?	Trenton
Where was Mohammad Hossein Barkhah born?	Tehran
Where was James Robert Rhind born?	Inverness
Where was Jean Hamilius born?	Luxembourg
Where was Danny Seward born?	Salford
Where was Stephen Grey born?	Rotterdam
Where was Louie Verrecchio born?	Baltimore
Where was Marcus Junkelmann born?	Munich
Where was John Dodington born?	Toronto
Where was Graham Salisbury born?	Philadelphia
Where was Bunny Johnson born?	Jamaica
Where was Cenk Renda born?	Turkey
Where was Mihael Brejc born?	Belgrade
Where was Gordon Baldwin born?	England
Where was Shlomo Shriki born?	Morocco
Where was Tatiana Belokonenko born?	Odessa
Where was Rob Childs born?	Derby
Where was Andreas Musalus born?	Crete
Where was Francesco Maria Bonini born?	Naples
Where was Raymond McGrath born?	Sydney
Where was Stephen Carter, Baron Carter of Barnes born?	Scotland
Where was Jack Macgougan born?	Belfast
Where was Julia Wilson born?	Sydney
Where was James Jordan born?	Chatham
Where was Wang Yong born?	Shanghai
Where was Ronny Swiggers born?	Belgium
Where was Sofia Ester born?	Lisbon
Where was Nathan Long born?	Australia
Where was Ylli Bufi born?	Tirana
Where was Sir Andrew Agnew, 8th Baronet born?	Edinburgh
Where was John Seru born?	Australia
Where was Sebastiano Maffettone born?	Naples
Where was Wang Wei born?	Beijing
Where was Theodore Baskin born?	Detroit
Where was Ferenc Sipos born?	Budapest
Where was Tadahisa Saizen born?	Tokyo
Where was Arthur Harold Stone born?	London
Where was Bransby Williams born?	London
Where was Walter Branscombe born?	Exeter
Where was Jeanne Deroin born?	Paris
Where was Frederick Pottinger born?	India
Where was Patrick Thomas Stone born?	Pembroke
Where was Andrea Neil born?	Vancouver
Where was Karl Albert Buehr born?	Germany
Where was Alexander Mullenbach born?	Luxembourg
Where was Gilbert John Arrow born?	London
Where was John Howard born?	London
Where was Elizur Goodrich born?	Durham
Where was Zenon Nowosz born?	Warsaw
Where was Greta Knutson born?	Stockholm
Where was Paul Daniels born?	Burlington
Where was Tom Jones born?	Dallas
Where was Elizabeth Bartlett born?	Deal
Where was Laura Moriarty born?	Honolulu
Where was David Moss born?	Doncaster
Where was Richard Tillinghast born?	Memphis
Where was Judith Mok born?	Bergen
Where was Eugen Enderlen born?	Salzburg
Where was Frank Farrell born?	Birmingham
Where was John Savage born?	Dublin
Where was Joel Honig born?	Chicago
Where was Jan Cox Speas born?	Raleigh
Where was Norman Spector born?	Montreal
Where was Peeter van Bredael born?	Antwerp
Where was John Jaffray born?	Stirling
Where was Sir William Coddington, 1st Baronet born?	Salford
Where was Azra Erhat born?	Istanbul
Where was Helen Sharsmith born?	Oakland
Where was Jeff Spiers born?	Belfast
Where was Ilus Vay born?	Budapest
Where was Igors Vihrovs born?	Riga
Where was Harry Chadwick born?	Toronto
Where was Franz Rummel born?	England
Where was Jim Grace born?	Dublin
Where was Ali Sarmini born?	Aleppo
Where was Robert Daniel Murphy born?	Milwaukee
Where was Shannon Emerick born?	Dallas
Where was Walter Gretzky born?	Ontario
Where was Kristian Geelmuyden born?	Oslo
Where was Tala Raassi born?	Iran
Where was Jules Louis Lewal born?	Paris
Where was Patrick Daughters born?	Berkeley
Where was Renaud Gagneux born?	Paris
Where was Elizabeth Burmaster born?	Baltimore
Where was Dave Mazzoni born?	Philadelphia
Where was Aamer Haleem born?	London
Where was John Van Lear McMahon born?	Maryland
Where was Jan Jacob Kieft born?	Amsterdam
Where was Wilhelmine von Hillern born?	Munich
Where was Tracey Magee born?	Belfast
Where was George Edward Hughes born?	Waterford
Where was Alexander Riese born?	Frankfurt
Where was Tina Kim born?	Seoul
Where was Bernard de Wolff born?	Amsterdam
Where was Peter Ording born?	Stade
Where was Branko Rasić born?	Serbia
Where was Ketil Hvoslef born?	Bergen
Where was John Carlin born?	Nottinghamshire
Where was Antonio Selvaggio born?	Palermo
Where was Michael Aufhauser born?	Augsburg
Where was Paula Tesoriero born?	Wellington
Where was John Marcum born?	Toledo
Where was Beth Liebling born?	Illinois
Where was José Bénazéraf born?	Casablanca
Where was Witold Nazarewicz born?	Warsaw
Where was Aarne Lakomaa born?	Finland
Where was Jerry Knight born?	California
Where was Yanitzia Canetti born?	Havana
Where was Ken Niles born?	Livingston
Where was Riccardo Maspero born?	Italy
Where was Margaret Maury born?	Kenya
Where was Bernard Wright born?	Jamaica
Where was Caroline Beil born?	Hamburg
Where was Joseph Judah Chorny born?	Minsk
Where was Thomas Godfrey Faussett born?	Oxford
Where was Árpád Soós born?	Budapest
Where was Samuel Davidson born?	Ireland
Where was Leonard Gyllenhaal born?	Sweden
Where was Sheyene Gerardi born?	Caracas
Where was Bryn Atkinson born?	Canberra
Where was Claudine Chomat born?	France
Where was Peter G. Engelman born?	London
Where was Stanis%C5%82aw Stolarczyk born?	Poland
Where was Sean Naylor born?	Calgary
Where was Jean Muller born?	Luxembourg
Where was Victoria Roberts born?	Manhattan
Where was Thomas F. Konop born?	Franklin
Where was Richard Cullen born?	Brooklyn
Where was Webster Edgerly born?	Massachusetts
Where was Peter Smedley born?	Perth
Where was Eric Ziebold born?	Iowa
Where was Adam Buszko born?	Warsaw
Where was Syms Covington born?	Bedford
Where was Joan Vincent Murray born?	London
Where was Gabriela Kulka born?	Warsaw
Where was Andrea Ratuski born?	Winnipeg
Where was Donald Haddow born?	Ontario
Where was Joe Daly born?	London
Where was Jane R. Goodall born?	Yorkshire
Where was Natalia Skobeeva born?	Russia
Where was Charles Murphy born?	Ottawa
Where was Charles Duncan born?	Middlesbrough
Where was Adel Sedra born?	Egypt
Where was William Wilson born?	Preston
Where was Thomas Bond born?	Somerset
Where was Michael Manuel born?	Tacoma
Where was James William Wallack born?	London
Where was Neil Swaab born?	Detroit
Where was Jean Cotelle born?	Paris
Where was Nick Hall born?	Birmingham
Where was Julie Aberg Robison born?	Madison
Where was Fina de Calderón born?	Madrid
Where was Gordan Kožulj born?	Zagreb
Where was Francis Henry Newbery born?	Devon
Where was Katherine Prescott Wormeley born?	England
Where was Avi Bortnick born?	Israel
Where was James L. Hogeboom born?	Ghent
Where was Samuel Kneeland born?	Boston
Where was Denise Holt born?	Vienna
Where was Riccardo Azzoli born?	Rome
Where was Russell Bawden born?	Queensland
Where was Bachar Kouatly born?	Damascus
Where was Charles Ignatius White born?	Baltimore
Where was John Halsey born?	Boston
Where was Russya born?	Kiev
Where was Brian White born?	Winnipeg
Where was Ashley Gilbertson born?	Melbourne
Where was Rosere Manguelle born?	France
Where was James A. MacAlister born?	Glasgow
Where was Dennis Rea born?	Chicago
Where was Nick Pugh born?	Paris
Where was Douglas Fee born?	Kingston
Where was Colin Carr born?	Liverpool
Where was Robert Harth born?	Louisville
Where was Pierre de Savoye born?	Montreal
Where was Lionello Grifo born?	Rome
Where was Marcin Gawron born?	Poland
Where was Alex Coke born?	Dallas
Where was Martinus Tels born?	Rotterdam
Where was Matthew Kent born?	Melbourne
Where was Johan de Graeff born?	Amsterdam
Where was Norbert Balatsch born?	Vienna
Where was Eugen von Halácsy born?	Vienna
Where was Fergus Morton, Baron Morton of Henryton born?	Glasgow
Where was Horatio Balch Hackett born?	Salisbury
Where was Pascal Aubier born?	Paris
Where was Steven Alexander born?	London
Where was Ray Sharp born?	Stirling
Where was Luke Youlden born?	Melbourne
Where was Michael Urbano born?	Sacramento
Where was Ernst Fries born?	Heidelberg
Where was Giovanni Polese born?	Venice
Where was Ellie Tesher born?	Toronto
Where was Alain de Cadenet born?	London
Where was Jemma Gawned born?	Perth
Where was Reginald Henry Campbell born?	Edinburgh
Where was Elfie W%C3%B6rner born?	Berlin
Where was Frederic Heath born?	Milwaukee
Where was Jimmy Norris born?	Newport
Where was John Baird born?	Glasgow
Where was Giacomo Luigi Brignole born?	Genoa
Where was Kenn Burke born?	Fife
Where was Anna Maria Villani Scicolone born?	Rome
Where was George Schlukbier born?	Germany
Where was Pietro Leonardi born?	Rome
Where was Ole Buck born?	Copenhagen
Where was Alastair Gordon born?	Sydney
Where was Dariusz Lipiński born?	Warsaw
Where was Che Arthur born?	Mobile
Where was Alan Wace born?	Cambridge
Where was Scientist born?	Kingston
Where was Pat Passlof born?	Brunswick
Where was Elizabeth Filippouli born?	Athens
Where was Al Harewood born?	Brooklyn
Where was Laurie Fisher born?	Canberra
Where was Neil M. Cohen born?	Newark
Where was Carl Blumenreuter born?	Berlin
Where was Ian Dench born?	Cheltenham
Where was George FitzGeorge born?	London
Where was Charles A. Barlow born?	Cleveland
Where was Didier Pfirter born?	Basel
Where was Jon Stock born?	England
Where was Michael Gallagher born?	Scotland
Where was Sergei Ordzhonikidze born?	Moscow
Where was John Clarke born?	Ireland
Where was A. G. E. Blake born?	Bristol
Where was Billy Hoffman born?	Atlanta
Where was Marcello Abbado born?	Milan
Where was Eugénie Söderberg born?	Heidelberg
Where was Russell Stannard born?	London
Where was Charles Ejogo born?	London
Where was George Clifford Sziklai born?	Budapest
Where was Mary Jean Stone born?	Brighton
Where was Mat Chivers born?	Bristol
Where was Linda MacLennan born?	Toronto
Where was Marthe Chenal born?	Paris
Where was Horatio Luro born?	Argentina
Where was Adolfo Davila born?	Mexico
Where was Charles Cotin born?	Paris
Where was Wayne Eagling born?	Montreal
Where was Aldo Franchi born?	Milan
Where was Dennis Frank Thompson born?	Ohio
Where was Ferenc Mérei born?	Budapest
Where was Roger Brunet born?	Toulouse
Where was Theodore Low De Vinne born?	Stamford
Where was Michael Francis Phelan born?	Lynn
Where was Celestino Sfondrati born?	Milan
Where was Samuel Verblunsky born?	London
Where was David Stainer born?	Exeter
Where was Andrew O'Neill born?	Portsmouth
Where was Gritakumar E. Chitty born?	Colombo
Where was Des Abbott born?	Darwin
Where was Dumont de Montigny born?	Paris
Where was Conrad Keely born?	England
Where was Titane Laurent born?	Morocco
Where was Edwin E. Wagner born?	Philadelphia
Where was Ronnie Stephenson born?	Sunderland
Where was Will Kirby born?	Florence
Where was Rosina Storchio born?	Venice
Where was Sylvester Rosa Koehler born?	Leipzig
Where was Julie Mullen born?	Liverpool
Where was Charles Kemper born?	Oklahoma
Where was Philip Smouha born?	Sydney
Where was Jan Jakob Tønseth born?	Oslo
Where was Tony Mitchell born?	Toronto
Where was Michel Host born?	Flanders
Where was Yang Yang born?	China
Where was Tom Mattera born?	Philadelphia
Where was Maarten Fontein born?	Leiden
Where was Brian Ervine born?	Belfast
Where was Takeshi Miyazawa born?	Canada
Where was Stephan Shakespeare born?	Germany
Where was John Barry born?	London
Where was Stanisław Urban born?	Warsaw
Where was Harvey Emerson Oswald born?	Columbus
Where was Alec Mullen born?	Irvine
Where was Alexander Mishnaevski born?	Moscow
Where was Leo Ehrnrooth born?	Sweden
Where was John William Thomson born?	Toronto
Where was Steve Arrington born?	Dayton
Where was Alexander C. Kirk born?	Angus
Where was Jimmy Gregg born?	Dublin
Where was Raymond Castilloux born?	Canada
Where was Florent Fidèle Constant Bourgeois born?	Paris
Where was Isaac Sharp born?	Dublin
Where was Asa G. Yancey, Sr. born?	Atlanta
Where was Robert Hamilton Paterson born?	Edinburgh
Where was Jan van Ispelen born?	Germany
Where was Harold Arthur Stuart born?	York
Where was Gerry Markman born?	Montreal
Where was Amber Parkinson born?	Melbourne
Where was Alexander Cores born?	Russia
Where was Homa Shaibany born?	Iran
Where was George Arnald born?	Berkshire
Where was William M. Crane born?	Elizabeth
Where was Samuel Joseph Fuenn born?	Vilnius
Where was Aurel S. Croissant born?	Germany
Where was Marie Fisher born?	Sydney
Where was Mihály Kovács born?	Budapest
Where was Susan Bullock born?	Cheshire
Where was Ximena Armas born?	Santiago
Where was John David Hennessey born?	London
Where was Simone Pasticcio born?	Genoa
Where was Andreas Lagios born?	Athens
Where was Michael Birt born?	Melbourne
Where was William Dimma born?	Montreal
Where was Harry Philbrick born?	Providence
Where was Lasse Lintilä born?	Finland
Where was Julia Kendell born?	Middlesex
Where was Nikos Aliagas born?	Paris
Where was James Fagan born?	Australia
Where was Hiram Hunter born?	Christchurch
Where was Lawrence Taub born?	Newark
Where was Samuel Gezalian born?	Odessa
Where was Taavi Vartia born?	Helsinki
Where was Akhtar Naraghi born?	Iran
Where was Friedrich Rehberg born?	Hanover
Where was Ernst Mehlich born?	Berlin
Where was Pierre Lecomte du Noüy born?	Paris
Where was Ahmet Esat Tomruk born?	Constantinople
Where was Jonah Smith born?	Syracuse
Where was Henry James born?	Boston
Where was Werner Münch born?	Westphalia
Where was Charles Weissmann born?	Budapest
Where was Ron Westrum born?	Chicago
Where was John M. Coffee born?	Tacoma
Where was Johnny Praize Hernandez born?	Newark
Where was William Taylor born?	Alexandria
Where was Alastair Layzell born?	Jersey
Where was Samuel Sterett born?	Carlisle
Where was Bobby Parker born?	Coventry
Where was Sun Lingfeng born?	Beijing
Where was Sheenagh Pugh born?	Birmingham
Where was Patricia Stokkers born?	Utrecht
Where was Necmi S%C3%B6nmez born?	Istanbul
Where was Jonathan Wilkins born?	London
Where was Harry Pelling Gill born?	Brighton
Where was Joan Brotat born?	Barcelona
Where was William Charles Brenke born?	Berlin
Where was Ernest Wilson Huffcut born?	Kent
Where was Clive Brooks born?	Bow
Where was Aleksandar Novaković born?	Belgrade
Where was Maja Tucholke born?	Leipzig
Where was Bruce Carmichael born?	Winnipeg
Where was Arthur Kinnaird, 11th Lord Kinnaird born?	Kensington
Where was Laszlo Gardony born?	Hungary
Where was Kelley Deal born?	Dayton
Where was William Henry Harrison Stowell born?	Windsor
Where was Serdar Apaydın born?	Turkey
Where was Barrett Martin born?	Olympia
Where was Sal Sparace born?	Italy
Where was Tzipora Laskov born?	Ukraine
Where was Frank Beck born?	Salisbury
Where was Robert Fulford born?	Colchester
Where was Saad Salman born?	Baghdad
Where was Jan Bull born?	Paris
Where was Terry Zahn born?	Milwaukee
Where was Murdoch Macdonald born?	Inverness
Where was Hugo Consuegra born?	Havana
Where was Mark Ettinger born?	Manhattan
Where was Winfield Myers born?	Georgia
Where was Daniel Steven Crafts born?	Detroit
Where was Rebekah Modrak born?	Pittsburgh
Where was Piero Rodarte born?	Mexico
Where was René Gagnier born?	Montreal
Where was Wang Beiming born?	Shanghai
Where was James Adler born?	Chicago
Where was Jüri Reinvere born?	Tallinn
Where was Lucille Wallenrod born?	Brooklyn
Where was Henry S. Magoon born?	Wisconsin
Where was Anna Kurska born?	Lviv
Where was Wally Stocker born?	London
Where was Cristy Coors Beasley born?	Memphis
Where was Viktor Ivan%C4%8Di%C4%87 born?	Sarajevo
Where was Eugène Lanti born?	Normandy
Where was Dominique de Williencourt born?	Lille
Where was Paul Zuccarelli born?	Milan
Where was Francisco de Osuna born?	Seville
Where was Emmanuel Aquin born?	Montreal
Where was Denis Denisenko born?	Moscow
Where was Jonathan Shearer born?	Glasgow
Where was Charles T. Clotfelter born?	Birmingham
Where was Stan Rosenthal born?	London
Where was Michael Shine born?	Warren
Where was Jonas Slier born?	Amsterdam
Where was Barry Mitcalfe born?	Wellington
Where was Jennifer Ness born?	Cheshire
Where was David Barstow born?	Boston
Where was György Bródy born?	Budapest
Where was William Russell Birch born?	Warwickshire
Where was Henry Taylor born?	Philadelphia
Where was Steve Sundholm born?	Portland
Where was Frederic Bayco born?	London
Where was Ethan Schreiber born?	Detroit
Where was Francis Waddelove born?	England
Where was Renato Caccioppoli born?	Naples
Where was John Heath born?	Worcester
Where was Leo Abrahams born?	England
Where was Innocente Alessandri born?	Venice
Where was Silja Ekeland Bjørkly born?	Bergen
Where was Harry Zvi Tabor born?	London
Where was Mirela Ivanova born?	Sofia
Where was Bobby Skafish born?	Hammond
Where was John Montague born?	Syracuse
Where was Józef Wieniawski born?	Lublin
Where was Joe Torres born?	Brooklyn
Where was Rhett Davies born?	London
Where was Saradindu Mukherjee born?	Kolkata
Where was Peter Smith born?	Mansfield
Where was Jennifer Moyle born?	Norwich
Where was Ottaviano Nonni born?	Bologna
Where was Vincenzo Re born?	Parma
Where was Göran Gentele born?	Stockholm
Where was Hamilton Sloan born?	Belfast
Where was Ann Corio born?	Hartford
Where was Brad Heald born?	Sydney
Where was Gordon Edward Corbould born?	Toronto
Where was Byron Fulcher born?	Cornwall
Where was Yvette Giraud born?	Paris
Where was Robert E. Merriam born?	Chicago
Where was Leszek Korzeniowski born?	Warsaw
Where was Eugene Elliott Reed born?	Manchester
Where was Cynthia Cruz born?	Germany
Where was Enrico Montesano born?	Rome
Where was Stephen McGonagle born?	Derry
Where was Kirk Hunter born?	Belfast
Where was Paul Lacroix born?	Paris
Where was Argiris Pedoulakis born?	Athens
Where was Andrei Soldatov born?	Moscow
Where was Yuki Matsuzawa born?	Tokyo
Where was Cliff Jones born?	London
Where was Daniel Dayan born?	Casablanca
Where was Zoltán Szilády born?	Budapest
Where was Warington Wilkinson Smyth born?	Naples
Where was Thomas Hoegh born?	Oslo
Where was Jan Schreiber born?	Wisconsin
Where was John Carlyle Herbert born?	Alexandria
Where was Stuart Ford born?	Sheffield
Where was John DeCew born?	Vermont
Where was John Boling born?	Indianapolis
Where was Peter Griffen born?	Adelaide
Where was Gregory Woods born?	Ghana
Where was K. Bhaskaran born?	Chennai
Where was Sergio Zaniboni born?	Turin
Where was Mike Delph born?	Indianapolis
Where was Tanis Rideout born?	Belgium
Where was Edwin Sutherland born?	Nebraska
Where was Anders Agensø born?	Denmark
Where was Alexander Smith born?	Edinburgh
Where was Brian Callison born?	Manchester
Where was Hanna Ożogowska born?	Warsaw
Where was Luis G. Pedraja born?	Cuba
Where was Adalbert Vitalyos born?	Hungary
Where was Eero Paloheimo born?	Helsinki
Where was Nick Grosso born?	London
Where was George Sutherland born?	Scotland
Where was Ludwig von Wohlgemuth born?	Vienna
Where was Nikhil Haldipur born?	Kolkata
Where was Kris Kane born?	Glasgow
Where was Albert Geouffre de Lapradelle born?	Paris
Where was Fran%C3%A7ois Desjardins born?	Montreal
Where was Marco Maccarini born?	Turin
Where was Hanna Thompson born?	Rochester
Where was Andrzej Mańka born?	Lublin
Where was Rika Noguchi born?	Tokyo
Where was Tobias Summerer born?	Bavaria
Where was Albert Warren Ferris born?	Brooklyn
Where was Hans Solereder born?	Munich
Where was Mark McCrea born?	Belfast
Where was László Z. Bitó born?	Budapest
Where was Brian Costello born?	Florida
Where was Georges Hugon born?	Paris
Where was Christfried Burmeister born?	Bradford
Where was Nick Greenstock born?	Dubai
Where was Thomas Wroth born?	London
Where was Aliuska López born?	Havana
Where was Vladeta Janković born?	Belgrade
Where was Staffan de Mistura born?	Stockholm
Where was Brett Hayman born?	Melbourne
Where was Mike Teasdale born?	Elgin
Where was Walter Hilgers born?	Germany
Where was Gilbert de Clare, 7th Earl of Gloucester born?	Christchurch
Where was Nektaria Karantzi born?	Greece
Where was Phil Dudderidge born?	Hertfordshire
Where was Edward Meredith Cope born?	Birmingham
Where was Boris Yampolsky born?	Ukraine
Where was Edith Leyrer born?	Vienna
Where was Susan Denin born?	Philadelphia
Where was Harrison Allen born?	Philadelphia
Where was Valentin Raychev born?	Sofia
Where was Kev Moore born?	Chesterfield
Where was Romuald Giegiel born?	Warsaw
Where was Léon Gimpel born?	Paris
Where was Colin Groves born?	England
Where was Azzedine Sakhri born?	Algiers
Where was Serafino Amedeo De Ferrari born?	Genoa
Where was Ahmet Gülhan born?	Ankara
Where was Duncan Fallowell born?	London
Where was Ernest Baldwin born?	Gloucester
Where was George Bruce Malleson born?	Wimbledon
Where was Matthew Price born?	London
Where was Ippongi Bang born?	Yokohama
Where was Alex Halberstadt born?	Moscow
Where was Richard Vale born?	London
Where was Alistair Griffin born?	Middlesbrough
Where was Gary Loizzo born?	Illinois
Where was Kim Mackay born?	Bathurst
Where was Benjamin Brecknell Turner born?	London
Where was Eduard Ortgies born?	Bremen
Where was Wilhelm Sander born?	Berlin
Where was Sampson Low born?	London
Where was Mario Theodoli born?	Rome
Where was Joy Williams born?	Sydney
Where was Adam McLean born?	Glasgow
Where was Philip Warwick born?	Westminster
Where was Kimiko Kasai born?	Kyoto
Where was Nina Repeta born?	Shelby
Where was Rudolf Křesťan born?	Prague
Where was David Atkinson born?	Montreal
Where was Edmund Port born?	Syracuse
Where was Sonya Emery born?	Austin
Where was Giuliano Ciannella born?	Palermo
Where was Otto Griessing born?	Munich
Where was Marcus Bierich born?	Hamburg
Where was Zhu Dawei born?	Shanghai
Where was Nicole Jordan born?	Oklahoma
Where was Hugh Andrew Johnstone Munro born?	Elgin
Where was Johnny Mowlem born?	London
Where was Hall Hibbard born?	Kansas
Where was Cris af Enehielm born?	Helsinki
Where was Mouloud Sihali born?	Algeria
Where was Patrick Lemarié born?	Paris
Where was Matthew Baillie Begbie born?	Mauritius
Where was Edward Gardner born?	Gloucester
Where was Marija Lugari%C4%87 born?	Zagreb
Where was Andrea Mátay born?	Budapest
Where was John P. Cassidy born?	Boise
Where was Glenn Cunningham born?	Bristol
Where was Richard Keese born?	Peru
Where was Safdar Malik born?	Lahore
Where was Francisca Pleguezuelos born?	Granada
Where was Laurie Allan born?	London
Where was Yves Roucaute born?	Paris
Where was Bob Alberti born?	Brooklyn
Where was Noah Creshevsky born?	Rochester
Where was Ivo Lukačovič born?	Prague
Where was Gary Titley born?	Salford
Where was Arseni Markov born?	Moscow
Where was Farid Chopel born?	Paris
Where was Martin Smith born?	Southampton
Where was Alice Gerrard born?	Seattle
Where was Sheyla Bonnick born?	Jamaica
Where was Brian G. W. Manning born?	Birmingham
Where was Stewart Brown born?	Southampton
Where was George Graham born?	Stirling
Where was Péter Lendvay born?	Budapest
Where was John Galea born?	Norfolk
Where was Arthur Andrews born?	Sunderland
Where was Ben Ali born?	Trinidad
Where was Hallgeir Langeland born?	Strand
Where was Michał Tober born?	Warsaw
Where was Howard Griffiths born?	Wales
Where was Philippe Lardy born?	Switzerland
Where was Moritz Hornes born?	Vienna
Where was Ken Little born?	Canyon
Where was Romain Pelletier born?	Montreal
Where was David Paton born?	Hamilton
Where was Henry Curtis Meanor born?	Cleveland
Where was Neil Fingleton born?	Durham
Where was Lionel Tiger born?	Montreal
Where was Charles Henry Douglass born?	Macon
Where was Harry Marshall Ward born?	Hereford
Where was Murat Evliyaoğlu born?	Turkey
Where was Jesse A. Hamilton born?	Portland
Where was Michael Anti born?	Nanjing
Where was Jan Kregel born?	Dallas
Where was Silas Halsey born?	Southampton
Where was Eugene Cotran born?	Jerusalem
Where was Herbert Kingsford born?	Dover
Where was Frank Sayers born?	London
Where was Thanhha Lai born?	Vietnam
Where was Kevin Noe born?	Dallas
Where was John Graham born?	Derby
Where was Stefanie van Vliet born?	Amsterdam
Where was Stephen Smyth born?	Derry
Where was Jacques Mehler born?	Barcelona
Where was Adam Gierek born?	Belgium
Where was Russell Trainer born?	Detroit
Where was James Bigwood born?	Bristol
Where was George Clark born?	Tulsa
Where was Byron Morrow born?	Chicago
Where was Hervé Alphand born?	Paris
Where was Georges Henri Roger born?	Paris
Where was Charles Tanguy born?	France
Where was Ethel du Pont born?	Wilmington
Where was Domenico Cunego born?	Verona
Where was Robert K. Brown born?	Monroe
Where was Festus Walters born?	Philadelphia
Where was Noel Moore born?	Yorkshire
Where was Oliver Bevan born?	Peterborough
Where was Alexander Pope Field born?	Louisville
Where was D'Arcy Browning born?	Edmonton
Where was George Rowe born?	Exeter
Where was Pierre Albuisson born?	Madagascar
Where was Simon Laurens born?	Jersey
Where was Clere Parsons born?	India
Where was Peter Wraxall born?	Bristol
Where was Louis Godin born?	Paris
Where was George William Knox born?	Rome
Where was Wayne Budd born?	Springfield
Where was George Jacobs born?	Massachusetts
Where was Claude Duflos born?	Paris
Where was Rod Anderson born?	Australia
Where was A. Ledyard Smith born?	Milwaukee
Where was Jean Pérol born?	Vienna
Where was Jorge Pacheco Klein born?	Montevideo
Where was Rambhau Mhalgi born?	Pune
Where was Edward Balfour born?	Angus
Where was Margaret Bloodworth born?	Winnipeg
Where was Eric Guillemain born?	Morocco
Where was John Whitworth born?	India
Where was Christine de Veyrac born?	Toulouse
Where was Felicia Montealegre born?	Chile
Where was Michael Finney born?	Woodland
Where was Ian Hancock born?	England
Where was Graham Roberts born?	Chester
Where was Peter Belches born?	Scotland
Where was Knut Tarald Taraldsen born?	Oslo
Where was Filippo Soffici born?	Florence
Where was Paul Hedqvist born?	Stockholm
Where was Vladimir Galkin born?	Kazan
Where was Sir George Bowyer, 7th Baronet born?	Berkshire
Where was Yelena Belyakova born?	Moscow
Where was Hakob Hakobian born?	Egypt
Where was Martin Jacques born?	Coventry
Where was Tajinder Singh Hayer born?	Bradford
Where was Jon Courtney born?	Reading
Where was Ruth Volgl Cardoso born?	Brazil
Where was Erwin Kelm born?	Minnesota
Where was Swami Sundaranand born?	India
Where was Jacob B. Grumet born?	Manhattan
Where was John Honeyman born?	Ireland
Where was George B. Rabb born?	Charleston
Where was Alexander Laner born?	Munich
Where was David Schrader born?	Chicago
Where was Darren Carr born?	Bristol
Where was Victor Borge born?	Copenhagen
Where was Xavier Garbajosa born?	Toulouse
Where was Philippe Risoli born?	Paris
Where was Omar Harfouch born?	Tripoli
Where was Harry Newton Redman born?	Illinois
Where was Frederic C. Lane born?	Lansing
Where was Josef Metternich born?	Cologne
Where was David Pangai born?	Tonga
Where was Stephen Fox born?	England
Where was Martyn Joseph born?	Wales
Where was Frederick Ringer born?	Norwich
Where was Thomas Johns Perry born?	Cumberland
Where was Robert Atherton born?	Liverpool
Where was Adolf von Bomhard born?	Augsburg
Where was Maria Kuznetsova born?	Odessa
Where was Pavel Žáček born?	Prague
Where was Spencer Swalm born?	Colorado
Where was Martin Duffy born?	Dublin
Where was Andre Coley born?	Jamaica
Where was Giacomo Vaghi born?	Como
Where was Andrew Martin born?	Cambridge
Where was Nikolay Atanasov born?	Sofia
Where was Fran%C3%A7ois-Anne David born?	Paris
Where was William Evans born?	Eton
Where was Tayyar Yalaz born?	Istanbul
Where was Dorothy Whitelock born?	Leeds
Where was Charles James Monk born?	Peterborough
Where was Ted Dey born?	Hull
Where was Kassim Mohamed born?	Kenya
Where was Phil Rose born?	Manchester
Where was Leslie Paul born?	Dublin
Where was Robert McCoy born?	Carlisle
Where was Bertrand Lamarche born?	Paris
Where was Gary Clark born?	Dundee
Where was John Macdonell born?	Scotland
Where was Francis J. Ricciardone, Jr. born?	Boston
Where was Darnell Kennedy born?	Mobile
Where was Anatoly Alexine born?	Moscow
Where was Shane McKenzie born?	Adelaide
Where was Kees Maks born?	Amsterdam
Where was Lewis Rendt born?	Germany
Where was Francisco Alimama Kashu born?	Hyderabad
Where was Katalin Karády born?	Budapest
Where was Giovanni Battista Pozzi born?	Milan
Where was Mariano Armellino born?	Rome
Where was Natalia Rom born?	Kazan
Where was Felice Giordano born?	Turin
Where was Lyubomir Ivanov born?	Sofia
Where was Danielle McGrath born?	Sydney
Where was Coral Amiga born?	London
Where was Eva Roth born?	Augsburg
Where was William Fletcher Burden born?	Troy
Where was John Lee born?	Oklahoma
Where was Sheik Sadeek born?	Guyana
Where was David Parry born?	London
Where was Tim Robinson born?	Yorkshire
Where was Alfred Ollivant born?	Manchester
Where was Wen Xiao Zheng born?	Shanghai
Where was John Mundy born?	England
Where was Christopher Packe born?	Norwich
Where was Yasmine Mahmoudieh born?	Germany
Where was Giovanni Battista Rinuccini born?	Rome
Where was Vic Lee born?	Shanghai
Where was John Purchas born?	Cambridge
Where was Parviz Jalayer born?	Tehran
Where was Henry Arthur Bright born?	Liverpool
Where was Louis Mazetier born?	Paris
Where was Richard Bristow born?	Worcester
Where was Noël Gallon born?	Paris
Where was Peter Martin born?	Galway
Where was Leo Alexander born?	Vienna
Where was Milan Orlowski born?	Prague
Where was Lahcen Abrami born?	Casablanca
Where was James Henry Emerton born?	Salem
Where was Ma Kelu born?	Shanghai
Where was Ulrik Cold born?	Copenhagen
Where was Lyman Tremain born?	Durham
Where was Pandeli Ralli born?	France
Where was Morgan Val Baker born?	Cornwall
Where was Jay Kennedy born?	Toledo
Where was Michael Griffith born?	Trinidad
Where was Frederick A. Pike born?	Calais
Where was Algernon Methuen born?	London
Where was Henri Perreyve born?	Paris
Where was David Robert Nelson born?	Stuttgart
Where was Federico López born?	Mexico
Where was Stephen Carr born?	Sydney
Where was Edmund H. Pendleton born?	Savannah
Where was William Hayter born?	Oxford
Where was Pat Gerber born?	Glasgow
Where was David McCarthy born?	Belfast
Where was Guiniforte Solari born?	Milan
Where was Derrick Leon born?	London
Where was Joseph Osgood Barrett born?	Bangor
Where was John Jenkins born?	England
Where was Rastko Cvetković born?	Belgrade
Where was John Snyder born?	Boston
Where was Trevor Burton born?	Aston
Where was Al Cotey born?	Chicago
Where was Jan Antonín Duchoslav born?	Prague
Where was Steve Francis born?	Phoenix
Where was Raymond Ericson born?	Brooklyn
Where was Valeriu Stoica born?	Bucharest
Where was Christian Murchison born?	Singapore
Where was Julie Duncan born?	Cornish
Where was James Moffat born?	Victoria
Where was Robert Erskine born?	Scotland
Where was Ralph Katz born?	Pittsburgh
Where was Bernard Cassen born?	Paris
Where was Gerhard Kraft born?	Heidelberg
Where was Lucas Auer born?	Austria
Where was Andrew Amos born?	India
Where was Richard Bathurst born?	Jamaica
Where was Stewart G. Honeck born?	Chicago
Where was Giovanni Francesco Commendone born?	Venice
Where was Mary Louise Smith born?	Montgomery
Where was Miglena Markova born?	Sofia
Where was Theodore J. van den Broek born?	Amsterdam
Where was Amy Sarkisian born?	Cleveland
Where was Thomas Barclay born?	Glasgow
Where was Mahdi Al Tajir born?	Bahrain
Where was David Sander born?	Melbourne
Where was Massimo Carello born?	Turin
Where was John Small born?	York
Where was Alizeh Imtiaz born?	Karachi
Where was Judith Vollmer born?	Pittsburgh
Where was Shay Gibbons born?	Dublin
Where was Gareth Knapman born?	Birmingham
Where was Keith Cozens born?	Surrey
Where was Dick Spotswood born?	California
Where was James Mumford born?	Norfolk
Where was Jack Blum born?	Toronto
Where was Mark Patton born?	Jersey
Where was Geoffrey Girard born?	Germany
Where was Zhu Xueqin born?	Shanghai
Where was Bonnie Ladwig born?	Milwaukee
Where was Imafuji Ch%C5%8Dtatsur%C5%8D born?	Tokyo
Where was Guo Jinlong born?	Nanjing
Where was Maude Duncan born?	Virginia
Where was Stan Fine born?	Pittsburgh
Where was Zhores Medvedev born?	Tbilisi
Where was Gael Suares born?	France
Where was Peter Nyborg born?	Gothenburg
Where was Julius Goldzier born?	Vienna
Where was Bill Jennings born?	Norwich
Where was Louis Gustave Ricard born?	Marseille
Where was Ephraim Paine born?	Canterbury
Where was Horatio Bisbee, Jr. born?	Canton
Where was S%C3%A9bastien Leblanc born?	Montreal
Where was Tom Lynskey born?	Galway
Where was DJ Uncle Al born?	Miami
Where was James Milnor Coit born?	Harrisburg
Where was Alan Thomson born?	Glasgow
Where was Slaw Rebchuk born?	Winnipeg
Where was Ashley Gilbertson born?	Australia
Where was Timothy Foote born?	London
Where was Irving Fiske born?	Brooklyn
Where was Tiziano Maggiolini born?	Rome
Where was Pat Foote born?	Durham
Where was Aco Petrović born?	Belgrade
Where was Endre Csillag born?	Budapest
Where was Thomas Bottomore born?	England
Where was Antonio Ciacca born?	Germany
Where was Chris Heimerdinger born?	Indiana
Where was Friedrich-August Schack born?	Silesia
Where was Christian Ferdinand Friedrich Krauss born?	Stuttgart
Where was Kumar Ponnambalam born?	Colombo
Where was Lucius Verus born?	Rome
Where was Neil Zakiewicz born?	London
Where was Odin Langen born?	Minneapolis
Where was Mark Howett born?	Perth
Where was Isaac Green Messec born?	Macon
Where was Elizabeth Kell born?	Sydney
Where was Joel Frost born?	Carmel
Where was Osku Palermaa born?	Finland
Where was Leopold Casper born?	Berlin
Where was Andrew Repasky McElhinney born?	Philadelphia
Where was Bunita Marcus born?	Madison
Where was Simon James born?	York
Where was Herbert Postle born?	Melbourne
Where was Charles Henry Turner born?	Wentworth
Where was Marc Chervel born?	Lille
Where was Hans Henrik Løyche born?	Copenhagen
Where was Terry Eviston born?	Dublin
Where was Francis Davis born?	Philadelphia
Where was Sarah Brandner born?	Munich
Where was Chubb Rock born?	Jamaica
Where was Francis Ernest Jackson born?	Huddersfield
Where was MWF born?	Memphis
Where was John Aspinall born?	Liverpool
Where was Brendon Sinclair born?	Hobart
Where was Paul Conway born?	Chicago
Where was Tarek Momen born?	Cairo
Where was Maryam Khan born?	Manchester
Where was Benzion Rakow born?	Frankfurt
Where was Mark Buchanan born?	Cleveland
Where was Justine Smethurst born?	Melbourne
Where was Davide Sorrenti born?	Naples
Where was Alessandro Frosini born?	Siena
Where was Bhai Balmukund born?	Pakistan
Where was Ellen Gulbranson born?	Stockholm
Where was Richard Bilby born?	Tucson
Where was Mary Akrivopoulou born?	Thessaloniki
Where was Scarlett Strallen born?	London
Where was Athanase Josué Coquerel born?	Amsterdam
Where was William Samuel Booze born?	Baltimore
Where was Frederick Fraley born?	Philadelphia
Where was Giuseppe Sabbatini born?	Rome
Where was Frederick Hartt born?	Boston
Where was Edward Fitzharris born?	Ireland
Where was Felicitas Kuhn born?	Vienna
Where was Kenny Brannigan born?	Glasgow
Where was João de Souza Mendes born?	Portugal
Where was Eugene Tzigane born?	Tokyo
Where was Gladys Henson born?	Dublin
Where was David Smith born?	London
Where was Carl Frederik Waage Beck born?	Copenhagen
Where was Catherine Vickers born?	Regina
Where was Alex Figge born?	Boulder
Where was E. Riley Anderson born?	Chattanooga
Where was Paul Belmondo born?	Algiers
Where was Sébastien Roch born?	Toulouse
Where was John McKay born?	Montreal
Where was Nahum Slouschz born?	Odessa
Where was Aigars Vītols born?	Riga
Where was Richard Bayley born?	Fairfield
Where was David Bret born?	Paris
Where was Guerguina Dvoretzka born?	Sofia
Where was Brendon Lindsay born?	Australia
Where was Judy Brooke born?	Leeds
Where was Carlos Sampayo born?	Argentina
Where was Tino Vegar born?	Split
Where was Thomas Guthrie Marquis born?	Chatham
Where was Robert Simpson Woodward born?	Rochester
Where was H. M. Green born?	Sydney
Where was Katerina Lemmel born?	Nuremberg
Where was Carlo Silipo born?	Naples
Where was Mary Moody Emerson born?	Concord
Where was Marc Matthews born?	Guyana
Where was Matthias Bjornlund born?	Copenhagen
Where was Henry Alfred Todd born?	Woodstock
Where was Richard Cawley born?	Doncaster
Where was Michael Halvarson born?	Stockholm
Where was Kerry Hannon born?	Pittsburgh
Where was Paul Boyd born?	Scotland
Where was Yannick Pouliot born?	Paris
Where was Hasna Xhukiçi born?	Albania
Where was Karl Chmielewski born?	Frankfurt
Where was Lawrence Kushner born?	Detroit
Where was Charles Frodsham born?	London
Where was William Henry Anderdon born?	London
Where was Martin Theodore Orne born?	Vienna
Where was Travis Bowen born?	Erie
Where was Bruce Hoblitzell born?	Louisville
Where was John Bridgeman born?	Exeter
Where was Frank Cole born?	Saskatchewan
Where was John McHale born?	Scotland
Where was Niels Bjerrum born?	Copenhagen
Where was Massimo Mazzucco born?	Turin
Where was No I.D. born?	Chicago
Where was J%C3%A9r%C3%B4me Inzerillo born?	Marseille
Where was Stewart Rawlings Mott born?	Flint
Where was Roderick Blaker born?	Montreal
Where was Amir Mohebbian born?	Tehran
Where was Abel Dimier born?	Paris
Where was Richard Armstrong born?	Leicester
Where was Jean Arnault born?	France
Where was Stephen Gough born?	Dublin
Where was Mick O'Brien born?	Dublin
Where was Omar Rezaq born?	Lebanon
Where was George Pearkes born?	Watford
Where was Malcolm Margolin born?	Boston
Where was Dominique Sanson born?	Paris
Where was Giovanni Battista Verger born?	Rome
Where was Dylan Taite born?	Liverpool
Where was Olof Bj%C3%B6rner born?	Stockholm
Where was Johan Daisne born?	Ghent
Where was Martin Weston born?	Worcester
Where was Mathieu Blin born?	Paris
Where was E. W. Dickes born?	London
Where was Siamak Hariri born?	Bonn
Where was Mircea Florian born?	Bucharest
Where was Kevin Robinson born?	Kilkenny
Where was Peter Driben born?	Boston
Where was Kim Ondaatje born?	Toronto
Where was Antigoni Goni born?	Athens
Where was Sikander Bakht born?	Karachi
Where was George Brimley born?	Cambridge
Where was William Ewart born?	Liverpool
Where was Pat Nixon born?	Nevada
Where was Angus Mackay born?	Lima
Where was Maynard Sinclair born?	Belfast
Where was Dani Gal born?	Jerusalem
Where was Robert Holden born?	Preston
Where was Paweł Zalewski born?	Warsaw
Where was Michael Carney born?	Waterford
Where was Donald Appleyard born?	England
Where was Thomas Tod Stoddart born?	Edinburgh
Where was Guy De Saint Cyr born?	Berlin
Where was Adrian Moore born?	Nottingham
Where was Amélie Mummendey born?	Bonn
Where was Claire Burch born?	Brooklyn
Where was Lloyd Youngblood born?	Beaumont
Where was World population milestones born?	Sarajevo
Where was Wilhelm Boger born?	Stuttgart
Where was Raffaele Scalese born?	Naples
Where was Vittorio Blanseri born?	Venice
Where was Felipe Alfau born?	Barcelona
Where was John Blackburn born?	Luton
Where was Cipriano de Valera born?	Seville
Where was Charles Collé born?	Paris
Where was Thierry Ehrmann born?	Lyon
Where was Alain Dorval born?	Algiers
Where was Sandrina Malakiano born?	Bangkok
Where was Romeo Niram born?	Romania
Where was Leon Dycian born?	Poland
Where was Mason Cook Darling born?	Amherst
Where was Bertram Stuart Straus born?	Manchester
Where was Earle J. Gluck born?	Maryland
Where was Jonathan B. Barry born?	Milwaukee
Where was Bernard Leclerc born?	France
Where was Dominic Dromgoole born?	Bristol
Where was Stanley Arthur Franklin born?	Bow
Where was Marc Sangnier born?	Paris
Where was Leslie Allen born?	Chicago
Where was Yang Yang born?	Beijing
Where was Lawrence E. Kahn born?	Troy
Where was Cornélie Falcon born?	Paris
Where was Wojciech Rychlik born?	Poland
Where was Frederick Webb Hodge born?	Plymouth
Where was Willis Jackson, Baron Jackson of Burnley born?	Burnley
Where was Diane Carlson Evans born?	Minnesota
Where was Joseph W. White born?	Cambridge
Where was Franz Dominic Grassi born?	Leipzig
Where was Stefano Nolfi born?	Rome
Where was Ibrahim Diarra born?	Paris
Where was Jennifer Holliday born?	Melbourne
Where was Peter Dowdeswell born?	London
Where was Anna Hegner born?	Basel
Where was Simon H. Rifkind born?	Lithuania
Where was Carey Beebe born?	Melbourne
Where was Wang Nan born?	China
Where was Eric Ash born?	Berlin
Where was Alaric Alexander Watts born?	London
Where was Joseph Isabelle born?	Hull
Where was Alexander Wilson born?	Virginia
Where was Jani Golob born?	Ljubljana
Where was Peyman Hooshmandzadeh born?	Tehran
Where was Walter Dulaney Addison born?	Annapolis
Where was Gary Franklin born?	Leipzig
Where was John Esposito born?	Brooklyn
Where was Walter Douglas born?	Glasgow
Where was Denys Page born?	Reading
Where was Brigitte Peucker born?	Germany
Where was Francis Williams born?	Kingston
Where was Alicia Thorgrimsson born?	Brandon
Where was Tolga Tekinalp born?	Turkey
Where was Wentworth Arthur Matthew born?	Lagos
Where was Harry B. Cohen born?	Winnipeg
Where was Eduardo Lago born?	Madrid
Where was Sir William Pearce, 2nd Baronet born?	Chatham
Where was Surinder Khanna born?	Delhi
Where was Tom Hamilton born?	Belfast
Where was Stephen Levine born?	Albany
Where was Gottlieb Bodmer born?	Munich
Where was Collins J. Seitz born?	Wilmington
Where was Jaan Arder born?	Tallinn
Where was Eva Maria Zuk born?	Poland
Where was Benjamin Enos born?	Richmond
Where was Richard Anthony born?	Cairo
Where was Arthur Neal born?	Sheffield
Where was Jan Kregel born?	Texas
Where was Henry Lerolle born?	Paris
Where was Leo Connellan born?	Portland
Where was Alain Deloche born?	Paris
Where was Charles Ramsay Arbuthnot born?	England
Where was Edward Stone Parker born?	London
Where was Samuel Lancaster Gerry born?	Boston
Where was Adrian Lombard born?	Coventry
Where was Lewis Yelland Andrews born?	Sydney
Where was Jim Boyd born?	Philadelphia
Where was James Whitworth born?	Sheffield
Where was Sahara Smith born?	Austin
Where was Hugues Krafft born?	Paris
Where was Barbara von Johnson born?	Munich
Where was Leib Ostrow born?	Detroit
Where was Chris Vaefaga born?	Auckland
Where was Henry Neele born?	London
Where was Buzzy Linhart born?	Pittsburgh
Where was Worthington Hooker born?	Springfield
Where was Fred Lecklider born?	Toledo
Where was Aleksander Żabczyński born?	Warsaw
Where was Gabriele Castagnola born?	Genoa
Where was Heather Jones born?	Edmonton
Where was Wang He born?	Beijing
Where was Gabrielle de Coignard born?	Toulouse
Where was David Aiken born?	Benton
Where was Allison H. Eid born?	Spokane
Where was Karen Young born?	Sheffield
Where was Emil Cesar born?	Ljubljana
Where was Mamta Kharab born?	Haryana
Where was Christelle Lefranc born?	Paris
Where was Jimmy Johnson born?	Sheffield
Where was Emma Ejwertz born?	Sweden
Where was Justin Hickey born?	Sydney
Where was Desmond T. Burke born?	Ottawa
Where was Matthew Mead born?	Buckinghamshire
Where was Thalia Pellegrini born?	London
Where was Shyril O'Steen born?	Seattle
Where was George Vicat Cole born?	Portsmouth
Where was Peter Sullivan born?	Virginia
Where was Barys Tasman born?	Minsk
Where was Vernon Knowles born?	Adelaide
Where was Paul Streeten born?	Austria
Where was Gerrit Noordzij born?	Rotterdam
Where was Aghasi Khanjian born?	Van
Where was Ignatius Cockshutt born?	Bradford
Where was Joseph Hislop born?	Edinburgh
Where was Eli Capilouto born?	Alabama
Where was Walter Ehrlich born?	Berlin
Where was Justin Wintle born?	London
Where was William Walcutt born?	Columbus
Where was Felix Rottenberg born?	Amsterdam
Where was Radovan Sloboda born?	Bratislava
Where was Olaf Rude born?	Estonia
Where was Charlene McMann born?	Chicago
Where was James Chalmers born?	Elgin
Where was Howard Loxton born?	Birmingham
Where was John Ferguson born?	Irvine
Where was Bernard Brodie born?	Chicago
Where was Philip Hershkovitz born?	Pittsburgh
Where was Philip Jeremiah Schuyler born?	Albany
Where was Kong Bai Ji born?	Shanghai
Where was Richard Beckett born?	Leeds
Where was Marty O'Neill born?	Winnipeg
Where was Gerard Hemsworth born?	London
Where was George Hulse born?	Liverpool
Where was Jack Petticord born?	Chicago
Where was Sylvia Wynter born?	Cuba
Where was Doğa Bekleriz born?	Istanbul
Where was Richard Bohn born?	Berlin
Where was Chris Pile born?	Warwickshire
Where was David Hackl born?	Toronto
Where was Tom Arnold born?	London
Where was Juan Carlos Zald%C3%ADvar born?	Cuba
Where was Robert Wayne Thomason born?	Tulsa
Where was Peter Dembicki born?	Vancouver
Where was Eduardo Prado Coelho born?	Lisbon
Where was Paul Hallez born?	Lille
Where was George Bruce born?	Scotland
Where was Louisa Stevenson born?	Glasgow
Where was Robert Moore born?	Hamilton
Where was Jean Noël Hallé born?	Paris
Where was Julian Paynter born?	Edinburgh
Where was Tania Corrigan born?	Auckland
Where was James Christie born?	Perth
Where was William Kraft born?	Chicago
Where was Juan Bautista de Lezana born?	Madrid
Where was Marcus Tuite born?	Dublin
Where was Paul Downes born?	Devon
Where was Eleni Cubitt born?	Greece
Where was Pieter de Molijn born?	England
Where was Gustav Bischof born?	Nuremberg
Where was Wayne Elcock born?	Birmingham
Where was Elnathan Sweet born?	Cheshire
Where was Gordon de Lisle Lee born?	Aberdeen
Where was Fran%C3%A7ois Ozenda born?	Marseille
Where was Nancy Metz White born?	Madison
Where was Shane Price born?	Melbourne
Where was Sir James Grant, 8th Baronet born?	Scotland
Where was Simone Iannarelli born?	Rome
Where was John Alfred Cuthbert born?	Savannah
Where was Edouard Grikurov born?	Tbilisi
Where was Timothy L. O'Brien born?	Illinois
Where was John L. Morrison born?	Scotland
Where was DJ Woody born?	Burnley
Where was Joshua Newtonn born?	Kerala
Where was Jeff Chandler born?	Philadelphia
Where was Godfrey Cripps born?	India
Where was Samuel von Schmettau born?	Berlin
Where was Margi Scharff born?	Memphis
Where was Lance Hayward born?	Bermuda
Where was Henry Bernard Carpenter born?	Dublin
Where was Paule Ka born?	Lille
Where was Rona Hartner born?	Bucharest
Where was Terry Wardle born?	Hereford
Where was Ishwardas Rohani born?	Karachi
Where was Leonard Strong born?	Utah
Where was Colin Kennedy born?	Hamilton
Where was Peter Freebody born?	Sydney
Where was Biff Mitchell born?	Toronto
Where was Alice Harrison born?	London
Where was Gabriel Bertrand born?	Paris
Where was Don Dixon born?	Easton
Where was Queenie van de Zandt born?	Canberra
Where was Thomas Playfere born?	London
Where was Georges Borchardt born?	Berlin
Where was Carlo Giuseppe Ratti born?	Genoa
Where was Martin Kosleck born?	Pomerania
Where was Bernhard Fries born?	Heidelberg
Where was Reed Hansen born?	Orlando
Where was Ron Waksman born?	Pittsburgh
Where was Sir John Borlase, 2nd Baronet born?	Buckinghamshire
Where was Marjorie Schwarzer born?	Boston
Where was William L. Ward born?	Greenwich
Where was Christa Goetsch born?	Bonn
Where was Robert John born?	Birmingham
Where was Leonard Bosack born?	Pennsylvania
Where was Juan Carlos Carbonell born?	Santiago
Where was Alberto Saichann born?	Argentina
Where was Gianni Iapichino born?	Florence
Where was Emmanuel Schelstrate born?	Antwerp
Where was Arthur William à Beckett born?	Fulham
Where was Arja Kajermo born?	Finland
Where was Bob McChesney born?	Maryland
Where was Petr Kroutil born?	Prague
Where was Thomas Pole born?	Philadelphia
Where was Jonathan Hunt born?	Massachusetts
Where was Albert Richard Pritchard born?	Rochester
Where was Joe Long born?	Elizabeth
Where was Gérald Gagnier born?	Montreal
Where was Vishal Marwaha born?	Glasgow
Where was Jos%C3%A9 Pou born?	Nicaragua
Where was Juan Manén born?	Barcelona
Where was Nazik Saba Yared born?	Jerusalem
Where was Jean Gallon born?	Paris
Where was Marga van Praag born?	Amsterdam
Where was Hiram Pitt Bennet born?	Carthage
Where was Pierre Joxe born?	Paris
Where was Hardial Bains born?	India
Where was Dennis Conta born?	Milwaukee
Where was Harrie Wood born?	Kensington
Where was Robert Logan Jack born?	Irvine
Where was Thomas Ebdon born?	Durham
Where was Nick Doody born?	Morley
Where was Salvador Cristau Coll born?	Barcelona
Where was Jason Hedlesky born?	Michigan
Where was Michael Guider born?	Melbourne
Where was Salomon Konijn born?	Amsterdam
Where was Zdzis%C5%82aw Najder born?	Warsaw
Where was Francis Dunlavy born?	Virginia
Where was Csaba Őry born?	Budapest
Where was Henri Jeanneret born?	Switzerland
Where was Nicholas Riccardi born?	Genoa
Where was Raymond Meier born?	Switzerland
Where was Graham Reilly born?	London
Where was William Ernest Brymer born?	Bath
Where was John Philp Thompson, Sr. born?	Dallas
Where was Anita Vogel born?	California
Where was Francis Hours born?	France
Where was Richard E. Council born?	Tampa
Where was Peter Verhoek born?	Auckland
Where was Dennis Davis born?	Manhattan
Where was Lukáš Kándl born?	Prague
Where was Eliza Stewart Boyd born?	Canada
Where was Thomas Dausgaard born?	Copenhagen
Where was James Powell born?	Eton
Where was Karl Friedrich von Klöden born?	Berlin
Where was Brad Farrow born?	Vancouver
Where was Jay Neill born?	London
Where was Stacy Clark born?	Buffalo
Where was David Needham born?	Leicester
Where was Arsen Savadov born?	Kiev
Where was Simon Binnendijk born?	Leiden
Where was Alan Davey born?	Ipswich
Where was Henry W. Lee born?	London
Where was Alfred Clarke born?	Nottingham
Where was Paul Varley born?	Preston
Where was Narado Brown born?	Kingston
Where was Jarvis Kenrick born?	Chichester
Where was Dwight Yates born?	Montana
Where was Anna Barriball born?	Plymouth
Where was Miriam Slater born?	California
Where was Mark Alton Barwise born?	Chester
Where was Dick Stockton born?	Philadelphia
Where was Jacques d'Agar born?	Paris
Where was Mohammad Mottahedan born?	Iran
Where was Scott Tennant born?	Detroit
Where was Käte Stresemann born?	Berlin
Where was Laurence Lampert born?	Winnipeg
Where was Tancrède Dumas born?	Italy
Where was James Brockway born?	Birmingham
Where was George Otto Wirz born?	Monroe
Where was Jeff Simmons born?	Seattle
Where was Robert Ford born?	Devon
Where was Artur Zawisza born?	Poland
Where was Edward Tufnell born?	Bath
Where was Robbie Regan born?	Wales
Where was Brent Barraclough born?	Canada
Where was Diego Delgadillo born?	Granada
Where was Erwin Lauper born?	Bern
Where was Charles Amos Cummings born?	Boston
Where was Chris Christenson born?	Norway
Where was Irfan Yusuf born?	Karachi
Where was Mark McCall born?	Bangor
Where was Charles H. Kraft born?	Connecticut
Where was Moses Hagiz born?	Jerusalem
Where was Elemér Terták born?	Budapest
Where was Haru Mutasa born?	Zimbabwe
Where was Morten Nordeide Johansen born?	Oslo
Where was Ana Maria Narti born?	Bucharest
Where was George P. Merrill born?	Auburn
Where was Kjersti Elvik born?	Bergen
Where was Maryem Tollar born?	Cairo
Where was Phillip Jackson born?	Chicago
Where was Tony Skabar born?	Ukraine
Where was Dávid Kovács born?	Budapest
Where was Monika Meyer born?	Berlin
Where was Claude Weisz born?	Paris
Where was Brian O'Riordan born?	Dublin
Where was Steven Hayward born?	Toronto
Where was Amy Chance born?	Hollywood
Where was Matt O'Connor born?	Manchester
Where was Sam Lynch born?	Limerick
Where was Kris Lefcoe born?	Montreal
Where was John Baptist de Faria born?	Portugal
Where was Federico Fabregat born?	Guadalajara
Where was Stefan Nystrom born?	Sweden
Where was Lucine Amara born?	Hartford
Where was Anna Livia Julian Brawn born?	Ireland
Where was Joe Zakas born?	Chicago
Where was John McLaren, Lord McLaren born?	Edinburgh
Where was David Basnett born?	Liverpool
Where was James Hamilton born?	Paisley
Where was Alexander Manning born?	Dublin
Where was Ornella Oettl Reyes born?	Germany
Where was Samuel Partridge born?	Norwich
Where was Aristides Brezina born?	Vienna
Where was Don Mankiewicz born?	Berlin
Where was Giorgio de Stefani born?	Verona
Where was Chafik Charobim born?	Cairo
Where was Alexander Garden born?	Scotland
Where was Brandt C. Louie born?	Vancouver
Where was Gunnar Samuelsson born?	Lima
Where was Stanley Morgan born?	Liverpool
Where was Peter Hargitai born?	Budapest
Where was JJ Horner born?	Minnesota
Where was Mary MacLeod Banks born?	Edinburgh
Where was Chris McKhool born?	Ottawa
Where was Vincent Laforet born?	Switzerland
Where was Bill Barminski born?	Chicago
Where was Sharon Duce born?	Sheffield
Where was Claude Piel born?	Paris
Where was Herbert James Carter born?	Marlborough
Where was Charles W. Moorman III born?	Cincinnati
Where was Hadi Sepehrzad born?	Tehran
Where was Sam Cosstick born?	Croydon
Where was Ursula Evje born?	Oslo
Where was Nasos Thanopoulos born?	Athens
Where was German Sims Woodhead born?	Huddersfield
Where was John Keen born?	Broadway
Where was Harry E. T. Thayer born?	Boston
Where was Edith Dimock born?	Hartford
Where was Roland Green born?	Victoria
Where was Bartle Brennen Bull born?	Toronto
Where was Daniel O'Mahony born?	Croydon
Where was Tony Southgate born?	Coventry
Where was Henry Bocking born?	Sheffield
Where was John McNamara born?	Cambridge
Where was Morris Sigman born?	Russia
Where was Prosper Garnot born?	Brest
Where was Masataka Yanagida born?	Tokyo
Where was Bertram Falle, 1st Baron Portsea born?	Jersey
Where was John Herbert Claiborne born?	Virginia
Where was Vicente Gómez born?	Honduras
Where was Luka Grubor born?	Zagreb
Where was Albert Pratz born?	Toronto
Where was Enrique Alciati born?	Marseille
Where was William Schoell born?	Manhattan
Where was Sarah Mytton Maury born?	Liverpool
Where was Francis Dunlap Gamewell born?	Camden
Where was Álvaro Fillol born?	Santiago
Where was Helen Longworth born?	Preston
Where was Kip King born?	Chicago
Where was Riccardo Truccolo born?	Italy
Where was George E. Waldo born?	Brooklyn
Where was Jonathan Robinson born?	Waterloo
Where was Lynne Cooke born?	Geelong
Where was James Brown born?	Blackburn
Where was George Kitching born?	Guangzhou
Where was Rhoda Holmes Nicholls born?	Coventry
Where was Virginia Leng born?	Malta
Where was Mark Farmer born?	London
Where was Frank Frankfort Moore born?	Limerick
Where was Snorre Valen born?	Oslo
Where was George Mavrotas born?	Athens
Where was Marco Napolioni born?	Rome
Where was Arne Rinnan born?	Oslo
Where was Maurice Tadadjeu born?	Cameroon
Where was John Hyacinth Power born?	Waterford
Where was Lester Spangler born?	Brook
Where was Robert Moss born?	Melbourne
Where was Pierre deMorlaix born?	France
Where was Linda Newell born?	Oregon
Where was Martin Malvy born?	Paris
Where was Maurice Vaïsse born?	Algiers
Where was Arnaldo Faustini born?	Rome
Where was Nat Patton born?	Texas
Where was Samuel Dick born?	Nottingham
Where was Edward Webster Bemis born?	Springfield
Where was Lew Jetton born?	Humboldt
Where was Axel Leonard Melander born?	Chicago
Where was John Mundy born?	Manchester
Where was Alex Garc%C3%ADa born?	Havana
Where was Luis Mu%C3%B1oz born?	Granada
Where was Franz Rosei born?	Vienna
Where was Tadeusz Browicz born?	Lviv
Where was Dave Berg born?	Portland
Where was Dilawar Hussain born?	Lahore
Where was Herbert Sanders born?	Wolverhampton
Where was Nico Gardener born?	Riga
Where was Victor Antoine Signoret born?	Paris
Where was John B. Foster born?	Gloucester
Where was Francis Allegra born?	Cleveland
Where was Wallace Bishop born?	Chicago
Where was Phil Lucas born?	Phoenix
Where was Roy Dalgarno born?	Melbourne
Where was Henry Woods born?	Bedford
Where was Diana Trask born?	Melbourne
Where was Alec Briggs born?	Sheffield
Where was Lynne Kositsky born?	Montreal
Where was Robert Boughey born?	Pennsylvania
Where was Cecil Copping born?	Lisbon
Where was Xavi Vallmajó born?	Barcelona
Where was Graham Ackerman born?	Seattle
Where was J.C. Patterson born?	Armagh
Where was Lawrence Willis born?	Lafayette
Where was Elizabeth Forbes born?	Ottawa
Where was Izolda Barudžija born?	Split
Where was Rolf Schock born?	France
Where was Joel Lion born?	France
Where was Jean Baptiste Claude Chatelain born?	Paris
Where was Alejandro Rossi born?	Florence
Where was Peter Hoover born?	Canada
Where was John Raven born?	Cambridge
Where was Alex González born?	Miami
Where was John Smyth born?	Ireland
Where was Gabriel Desjardins born?	Montreal
Where was Abhijit Kunte born?	Pune
Where was Mark Koevermans born?	Rotterdam
Where was Espen Giljane born?	Oslo
Where was William Harrison Courtney born?	Baltimore
Where was David Mercer born?	Swansea
Where was Princess Bee born?	Italy
Where was Jeffrey H. Cohen born?	Brooklyn
Where was Charles Alford born?	Somerset
Where was Andrew Crofts born?	England
Where was Marcus Tsutakawa born?	Seattle
Where was Ken Fowler born?	Fargo
Where was Henry Robertson Hartley born?	Southampton
Where was Mark Cooksey born?	England
Where was Janet Coster born?	London
Where was Sun Lingfeng born?	China
Where was Ed Pizunski born?	Toronto
Where was Grant McNally born?	Vancouver
Where was Edward Locke born?	England
Where was Zsolt Hamar born?	Budapest
Where was Murray McEachern born?	Toronto
Where was Aboubacar Sankhare born?	France
Where was David Marusek born?	Buffalo
Where was Liljana Lu%C4%8Di%C4%87 born?	Belgrade
Where was Enrico Toselli born?	Florence
Where was Walter Bowers Pillsbury born?	Burlington
Where was John Butts born?	Cork
Where was John Cobbett born?	Edinburgh
Where was Minas Gekos born?	Constantinople
Where was Andrew Patterson born?	Belfast
Where was Alexander Ferdinand von der Goltz born?	Prussia
Where was Paul Keenan born?	Lisbon
Where was Barry Howard born?	Nottingham
Where was Mary Ann Kennedy born?	Glasgow
Where was Bruno Arpaia born?	Naples
Where was Simone Orlando born?	Vancouver
Where was Jazzy Jay born?	Beaufort
Where was Binem Heller born?	Warsaw
Where was Olivia Poulet born?	London
Where was Christoph M. Schmidt born?	Canberra
Where was Siamak Shayeghi born?	Iran
Where was Mike Shank born?	Columbus
Where was Spiro Zavos born?	Wellington
Where was Tommie Lindsey born?	Oakland
Where was Aneesh Kapil born?	Wolverhampton
Where was Bijoy Goswami born?	Bangalore
Where was Henry Beecher Dierdorff born?	Seville
Where was Samuel Barton born?	Virginia
Where was John Augustus Stone born?	Concord
Where was Thomas Rickner born?	Rochester
Where was Max Coyer born?	Hartford
Where was Serge Losique born?	Yugoslavia
Where was John B. Snook born?	England
Where was Bódog Török born?	Budapest
Where was Lawrence Townsend born?	Philadelphia
Where was Abdou Cherif born?	Casablanca
Where was Joseph Paul Cretzer born?	Minneapolis
Where was Gregory V. Palmer born?	Philadelphia
Where was Nathaniel Culverwell born?	Middlesex
Where was John Friedrich born?	California
Where was Jean Trembley born?	Geneva
Where was Giuseppe Simonelli born?	Naples
Where was John Warrock born?	Richmond
Where was Antonietta Pastori born?	Milan
Where was Dhyanyogi Madhusudandas born?	Bihar
Where was Hiba Daniel born?	Lebanon
Where was Jacob Murey born?	Moscow
Where was Emmy Verhey born?	Amsterdam
Where was Alain Ehrenberg born?	Paris
Where was Santiago I%C3%B1iguez de Onzo%C3%B1o born?	Madrid
Where was Aleksandra Romanić born?	Zagreb
Where was Gayathri Mudigonda born?	India
Where was Robert E. Wright born?	Rochester
Where was Thomas Nassi born?	Albania
Where was Emanuel Brouwer born?	Amsterdam
Where was Tariq Hashim born?	Baghdad
Where was David Lake born?	Bangalore
Where was Frederick Ellsworth Mather born?	Windsor
Where was Tim Davis born?	Milwaukee
Where was Howard Griffiths born?	Swansea
Where was Edward Raymond Neaher born?	Brooklyn
Where was John Chillag born?	Vienna
Where was Rich Meyer born?	Cincinnati
Where was Neil Rackham born?	England
Where was G%C3%B6khan Bozkaya born?	Germany
Where was Martin Kratochvíl born?	Prague
Where was Gaspard Terrasson born?	Lyon
Where was George Mudie born?	Edinburgh
Where was Joseph Wilhelm Swoboda born?	Prague
Where was John Metcalfe born?	Wellington
Where was Tim Long born?	Brandon
Where was Gonzalo Pieres, Sr. born?	Argentina
Where was Donald Kalish born?	Chicago
Where was Vladimir Georgiev born?	Sofia
Where was Yu Huili born?	Sichuan
Where was Alexandra Mazur born?	Moscow
Where was Nicole Hackett born?	Sydney
Where was Carl Ludwig Brandt born?	Holstein
Where was Aida Schlaepfer born?	Baghdad
Where was Amy Neftzger born?	Illinois
Where was Samuel Bourn the Elder born?	Derby
Where was Hans Reiche born?	Berlin
Where was Berthold Weisz born?	Budapest
Where was Marcia Gygli King born?	Cleveland
Where was Edmund Hobhouse born?	London
Where was Frederick Lewis Allen born?	Boston
Where was Alice Robie Resnick born?	Erie
Where was Philip Sington born?	Cambridge
Where was Nick Conrad born?	Norwich
Where was Anastasius I born?	Rome
Where was Ernst Friedrich born?	Paris
Where was Roy Sekoff born?	Miami
Where was Samuel Rickard Christophers born?	Liverpool
Where was David Schnitter born?	Newark
Where was Jamie Moses born?	Ipswich
Where was Takeshi Maeda born?	Tokyo
Where was Brian Plummer born?	Saskatchewan
Where was Joseph R. Chenelly born?	Rochester
Where was Brian Faloon born?	Belfast
Where was Antonio Tosti born?	Rome
Where was Mehmet Ali İrtemçelik born?	Istanbul
Where was Dmitry Grigorieff born?	London
Where was Adolphe Cohn born?	Paris
Where was Alexander Hangerli born?	Istanbul
Where was Lorne Rubenstein born?	Toronto
Where was Flemming Lassen born?	Copenhagen
Where was James O'Mara born?	Limerick
Where was Davis Gaines born?	Orlando
Where was Donald W. Steinmetz born?	Milwaukee
Where was Crist%C3%B3bal de Aguilar born?	Lima
Where was Rüdiger Frank born?	Leipzig
Where was Edward Romilly born?	London
Where was Essie Sakhai born?	Iran
Where was Francis W. Cushman born?	Brighton
Where was Ursula Hoff born?	London
Where was Carol Klimpel born?	Ontario
Where was Alec Statham born?	Coventry
Where was Marianne Peretti born?	Paris
Where was Matteo Barzini born?	Rome
Where was Alejandro Abellan born?	Ottawa
Where was Douglas Simpson born?	Glasgow
Where was Andrea Lekić born?	Belgrade
Where was Danny Roxo born?	Portugal
Where was Tommy Waidelich born?	Stockholm
Where was Hazard E. Reeves born?	Baltimore
Where was Crystal Mangum born?	Durham
Where was Andrea Giani born?	Naples
Where was Clive Gee born?	Ireland
Where was Vincent A. Mahler born?	Chicago
Where was John Hawthorne born?	Sydney
Where was Miryana Ivanova Basheva born?	Sofia
Where was Mordehai Dubin born?	Riga
Where was Matthew Hall McAllister born?	Savannah
Where was Thomas Morland born?	Montreal
Where was Leigh Diffey born?	Brisbane
Where was Yuan Yufang born?	Beijing
Where was Shahin Afrassiabi born?	Tehran
Where was Klaus Röder born?	Stuttgart
Where was Eric Swinkels born?	Best
Where was Henry Hiles born?	Shrewsbury
Where was Gottfried Heinrich Bach born?	Leipzig
Where was Silke Bodenbender born?	Bonn
Where was Frank Kaderabek born?	Chicago
Where was Ian Steel born?	Glasgow
Where was Ebbe Hamerik born?	Copenhagen
Where was Robert Lecou born?	Paris
Where was William Child born?	Bristol
Where was Edwin Edgar Voigt born?	Illinois
Where was Tony Kaldas born?	Cairo
Where was Silvana Cruciata born?	Naples
Where was Ernest Luxembourg Wright born?	Massachusetts
Where was Vivion de Valera born?	Dublin
Where was Francis Montague Holl born?	London
Where was Miguel García García born?	Barcelona
Where was Charles Marston born?	Wolverhampton
Where was Barry Upton born?	Hastings
Where was Dave Hilton born?	England
Where was Caleb H. Baumes born?	Bethlehem
Where was William Gifford Palgrave born?	Westminster
Where was Hugh Fraser, 1st Baron Fraser of Allander born?	Glasgow
Where was Matthew Taylor born?	Miami
Where was Ed Rossbach born?	Chicago
Where was Augusto De Marsanich born?	Rome
Where was František Neuwirt born?	Prague
Where was John Myres born?	Preston
Where was John Marshall Evans born?	Virginia
Where was Chad Hartigan born?	Cyprus
Where was Henry Bentley born?	Westminster
Where was Manuel Su%C3%A1rez %C3%81vila born?	Trinidad
Where was Juris Sokolovskis born?	Riga
Where was Tommy Rustad born?	Oslo
Where was Rick Holbrook born?	Chicago
Where was Allan Stewart born?	Edinburgh
Where was Stephen Codman born?	Norwich
Where was John Arneil born?	India
Where was Tomislav Smoljanović born?	Split
Where was Claire Ritter born?	Charlotte
Where was Dino Wells born?	Chicago
Where was Eric Robson born?	Scotland
Where was Herbert J. Davenport born?	Vermont
Where was Dave Wood born?	Manchester
Where was Rob Shelby born?	Detroit
Where was Jennifer Smith born?	Lisbon
Where was Mike Peden born?	Edinburgh
Where was Richard Collins, Baron Collins born?	Dublin
Where was Alonso del Arco born?	Madrid
Where was Ömer Kaner born?	Istanbul
Where was Davor Sučić born?	Sarajevo
Where was Pa Neumüller born?	Stockholm
Where was Jeremiah H. Pierson born?	Newark
Where was Walter Elliot born?	Edinburgh
Where was Brent Rickles born?	London
Where was John Mahaffy born?	Montreal
Where was Sofia Scalchi born?	Turin
Where was Petra Krug born?	Dresden
Where was Theron R. Strong born?	Salisbury
Where was Sathyabhama Das Biju born?	Kerala
Where was Petar %C4%8Culi%C4%87 born?	Split
Where was Lev Leshchenko born?	Moscow
Where was Jesper Nordin born?	Stockholm
Where was Martin Henriksson born?	Sweden
Where was John Chester Buttre born?	Auburn
Where was Henry Duckworth born?	Brandon
Where was Kaoru Kakudo born?	Japan
Where was Antony Cooke born?	Sydney
Where was Michel Dovaz born?	Geneva
Where was Ingrid Eide born?	Oslo
Where was Constantinos Decavallas born?	Athens
Where was Thomas Reeve born?	Langley
Where was Jörgen Dafgård born?	Gothenburg
Where was Shiva Boloorian born?	Tehran
Where was Georgina Kennard born?	Edinburgh
Where was Alexandre Desgoffe born?	Paris
Where was Olaf Poulsen born?	Oslo
Where was Andrew Bell born?	London
Where was Jack Curtner born?	Greenville
Where was Rafael Garzón Rodríguez born?	Granada
Where was Louis Joseph Coralie born?	Mauritius
Where was Carlo Fatuzzo born?	Genoa
Where was Ernest E. Wood born?	Chico
Where was Robb Gravett born?	London
Where was Anton Altmann born?	Vienna
Where was Réginald Bernut born?	Sydney
Where was Henry Hudson Kitson born?	Huddersfield
Where was Frank P. Incropera born?	Lawrence
Where was Martin Wright born?	Germany
Where was Rose Prince born?	England
Where was William Doan born?	Maine
Where was Stanis%C5%82awa Nowicka born?	Warsaw
Where was Énemond Massé born?	Lyon
Where was Károly Varga born?	Budapest
Where was David J. Eicher born?	Oxford
Where was Richard Corbould born?	London
Where was Ethan Mordden born?	Pennsylvania
Where was Thomas Adams born?	London
Where was Staffan de Mistura born?	Sweden
Where was Françoise Claustre born?	Paris
Where was Alejandro Colina born?	Caracas
Where was Virginio Colombo born?	Milan
Where was Franco Gentilesca born?	Brooklyn
Where was Mehran Khaghani born?	London
Where was Zhang Lei born?	Nanjing
Where was Desi Williams born?	London
Where was Robert McCrindle born?	Glasgow
Where was Christopher Benfield Carter born?	Montreal
Where was Edward Isaac Ezra born?	Shanghai
Where was Steve Free born?	Portsmouth
Where was Charles Reynolds Brown born?	Bethany
Where was Simon Cooke born?	Manchester
Where was Conyers Middleton born?	Richmond
Where was Bo Weavil Jackson born?	Birmingham
Where was Kay Lahusen born?	Cincinnati
Where was John O'Keefe born?	Waterloo
Where was Jamal Jumá born?	Baghdad
Where was Anwar Khan born?	Karachi
Where was Laurence Stallings born?	Macon
Where was Rick Lawson born?	Raymond
Where was Diego Francisco Altamirano born?	Madrid
Where was Eric Aarons born?	Sydney
Where was Charles Dixon born?	London
Where was Johann Christoph Friedrich Klug born?	Berlin
Where was Edwin Grant Dexter born?	Calais
Where was Arthur Napoleão dos Santos born?	Porto
Where was Edgar Sydney Little born?	London
Where was Cedric Myton born?	Jamaica
Where was Robert Jankel born?	London
Where was Jacqueline Carey born?	Cambridge
Where was William Presser born?	Michigan
Where was Natallia Helakh born?	Brest
Where was Yvette Higgins born?	Sydney
Where was Clement Payne born?	Trinidad
Where was Dragoș Neagu born?	Bucharest
Where was Theodore Augustine Mann born?	Yorkshire
Where was Lloyd Turner born?	Australia
Where was Louise Christian born?	Oxford
Where was Silas Bowker born?	Concord
Where was Penny Lernoux born?	California
Where was Serge Postigo born?	France
Where was Mary Lou Munts born?	Chicago
Where was Mitra Tabrizian born?	Tehran
Where was Zeng Fanyi born?	Shanghai
Where was Rani Price born?	Liverpool
Where was Lorne Resnick born?	Toronto
Where was Fabrizio Marrella born?	Venice
Where was Mónica Estarreado born?	Madrid
Where was Catherine Wellesley, Duchess of Wellington born?	Dublin
Where was Oliver Lieb born?	Frankfurt
Where was Jennifer Clulow born?	Grimsby
Where was Regina Sarfaty born?	Rochester
Where was William C. Clark born?	Greenwich
Where was Léonce Alloy born?	Paris
Where was W. T. Pfefferle born?	Hamilton
Where was Torgeir Micaelsen born?	Bergen
Where was Joseph Bennett born?	Grimsby
Where was Frederick Gunton born?	Norwich
Where was Zoran Popovich born?	Akron
Where was Ángel Garma born?	Spain
Where was Pernille Rose Gr%C3%B8nkj%C3%A6r born?	Denmark
Where was Mohammed Loay Bayazid born?	Syria
Where was Graph Nobel born?	Toronto
Where was Robert van der Zant born?	Queensland
Where was Edward Duyker born?	Melbourne
Where was Boris Grushin born?	Moscow
Where was Sumalee Montano born?	Columbus
Where was Juan Alfon born?	Toledo
Where was Claude Bourgelat born?	Lyon
Where was Henri de Contenson born?	Paris
Where was Morton Estrin born?	Burlington
Where was Yasir Butt born?	Lahore
Where was Carlo Emery born?	Naples
Where was Magnus Rosén born?	Gothenburg
Where was Alan Aboud born?	Dublin
Where was Zoltan Kósz born?	Budapest
Where was Alistair Elliot born?	Liverpool
Where was George Fisher born?	Franklin
Where was Cleve Chaffin born?	Kentucky
Where was Sal Cannella born?	Newark
Where was Sherry Kramer born?	Springfield
Where was Hendrick Andriessen born?	Antwerp
Where was Carl Herman Kraeling born?	Brooklyn
Where was Adolphus Drucker born?	Amsterdam
Where was Eileen O'Keeffe born?	Kilkenny
Where was Deyan Vatchkov born?	Sofia
Where was André Léri born?	Paris
Where was Nicolás Antonio de Arredondo born?	Madrid
Where was Aaron of Lincoln born?	Lincoln
Where was Martin Jervan born?	Tallinn
Where was Pankaj Dharmani born?	Delhi
Where was Nick Dranias born?	Chicago
Where was John Abram born?	England
Where was Laurent Petitguillaume born?	Tours
Where was Walter J. Mahoney born?	Buffalo
Where was William Buik born?	Dundee
Where was Frank J. Webb born?	Philadelphia
Where was William Garnett born?	London
Where was Sylvester Ahola born?	Gloucester
Where was Petras Geniušas born?	Vilnius
Where was Joy Katz born?	Newark
Where was Michael Khodarkovsky born?	Odessa
Where was Arthur N. Martin born?	Toronto
Where was Shibley Telhami born?	Israel
Where was Jim Berry born?	Oklahoma
Where was Joshua Toulmin Smith born?	Birmingham
Where was Alain Boire born?	Montreal
Where was Yash Daryanani born?	Chennai
Where was Marty Radovanic born?	Cleveland
Where was Sara Badr born?	Cairo
Where was Norbert Wissing born?	Amsterdam
Where was Sergey Kozlov born?	Moscow
Where was Michael Armstrong born?	France
Where was Charles Crawford born?	Nashville
Where was Luděk Frýbort born?	Prague
Where was Frédéric Durieux born?	Paris
Where was Fabian Francis born?	Darwin
Where was Jan Szyszko born?	Warsaw
Where was Nathalie De Vos born?	Ghent
Where was George Stone born?	Fulham
Where was Andy King born?	Vancouver
Where was John Randall Reding born?	Portsmouth
Where was Peter F. Donnelly born?	Lynn
Where was Anton Foljambe born?	Christchurch
Where was Bertie Felstead born?	London
Where was Mary Cecil Allen born?	Melbourne
Where was Kazimierz Flatau born?	Warsaw
Where was Edward Schoeneck born?	Syracuse
Where was Neal Peters McCurn born?	Syracuse
Where was Alan MacDonald born?	Watford
Where was Alby Why born?	Sydney
Where was Ben Nicholas born?	Adelaide
Where was Michelle Rogers born?	Salford
Where was Mark Gosling born?	Birmingham
Where was Michel Frutschi born?	Geneva
Where was Graham Doyle born?	Dublin
Where was Anne Audain born?	Auckland
Where was Eugene A. Toepel born?	Bangor
Where was Benjamin Castleman born?	Everett
Where was Harry W. Wellford born?	Memphis
Where was Albertus Jonas Brandt born?	Amsterdam
Where was Victor Krasin born?	Kiev
Where was Omar Abdel Aziz born?	Cairo
Where was Joe Ascione born?	Brooklyn
Where was Liam McMahon born?	Ireland
Where was Martin Firrell born?	France
Where was Ignacio Matte Blanco born?	Santiago
Where was Marc Hostert born?	Luxembourg
Where was Tom Kazas born?	Sydney
Where was Michael Brennan born?	Sydney
Where was Clinton D. McKinnon born?	Dallas
Where was Ronnie Le Drew born?	Toronto
Where was Simon Gerada born?	Melbourne
Where was Michael Greco born?	Dunbar
Where was James Travers born?	Hamilton
Where was Carol Graham born?	Lima
Where was Valli Valli born?	Berlin
Where was Francis Asbury Baker born?	Baltimore
Where was Rafael E. Martinez born?	Cuba
Where was Arthur Barnett born?	Dunedin
Where was Antonia Okonma born?	London
Where was Noush Skaugen born?	Sweden
Where was Roger Mears born?	Wichita
Where was Martin Gero born?	Switzerland
Where was John Duncombe born?	London
Where was Chris Welsby born?	Exeter
Where was Harry Freedman born?	London
Where was Bobby McDonald born?	Aberdeen
Where was Thomas Scott born?	Pennsylvania
Where was Luca Princiotta born?	Como
Where was Christine Melnick born?	Winnipeg
Where was Philippa Perry born?	Warrington
Where was Thomas Webley born?	Bristol
Where was Luigi Attademo born?	Naples
Where was Karolina Kosińska born?	Warsaw
Where was Jacques Autreau born?	Paris
Where was Werner Ploberger born?	Vienna
Where was Ephraim Hertzano born?	Romania
Where was Thomas Davidson born?	Nottingham
Where was Eileen Beldon born?	Bradford
Where was Edward Alfred Cowper born?	London
Where was John Tierney born?	Derry
Where was Norman Macdonnell born?	Pasadena
Where was Heinrich Hirschsprung born?	Copenhagen
Where was David Vaughan born?	London
Where was Gregory Woods born?	Egypt
Where was Symeon Cosburn born?	London
Where was Joanne Fox born?	Melbourne
Where was Federico Cervelli born?	Milan
Where was Al Lerner born?	Cleveland
Where was Rowley Leigh born?	Manchester
Where was Parvaz Mirza born?	Birmingham
Where was Mark Mitchell born?	Auckland
Where was Stuart Pearson Wright born?	Northampton
Where was Brett Warton born?	Sydney
Where was Fredrik Liliegren born?	Lund
Where was Gottlob Christian Storr born?	Stuttgart
Where was Donovan Blake born?	Jamaica
Where was Paula Malai Ali born?	Brunei
Where was Joe Zakas born?	Illinois
Where was Jason Colwell born?	Dublin
Where was Joachim Martin Falbe born?	Berlin
Where was Malcolm Cecil born?	London
Where was Lawrence Cherney born?	Peterborough
Where was Morris Schwartz born?	Russia
Where was Burkey Belser born?	Columbia
Where was Carly Milne born?	Edmonton
Where was Bill Utterback born?	Illinois
Where was Marcello Vernola born?	Bari
Where was Barbara Clark born?	Alberta
Where was Joseph Beer born?	Bohemia
Where was Humphrey Hopkin born?	Nottingham
Where was Albert Vizentini born?	Paris
Where was Herbert Bowden, Baron Aylestone born?	Cardiff
Where was Enid Bibby born?	Sheffield
Where was Chris Lyttle born?	Belfast
Where was Émile Lévy born?	Paris
Where was Freddy Marshall born?	Caracas
Where was Theodore G. Garfield born?	Humboldt
Where was Cathy Sisler born?	Wisconsin
Where was Rusty Egan born?	London
Where was Otto Mainzer born?	Frankfurt
Where was Françoise Romand born?	Marseille
Where was Iraj Kalantari Taleghani born?	Tehran
Where was Helen Thomas Dranga born?	Oxford
Where was Li Lei born?	China
Where was Randolph Runnels born?	Texas
Where was Jeremy Current born?	Charlotte
Where was Fuat Güner born?	Istanbul
Where was William Reed born?	Montreal
Where was Arthur Anae born?	Fiji
Where was Jacques Cartier born?	Quebec
Where was Alexander Yossifov born?	Sofia
Where was Alireza Sheikhattar born?	Tehran
Where was Martin Brown born?	Melbourne
Where was Victoria LePage born?	Melbourne
Where was Nabil Seidah born?	Egypt
Where was James Macdonald born?	Aberdeen
Where was Nigel Preston born?	London
Where was William Hardy born?	Jamaica
Where was Richard S. Whaley born?	Charleston
Where was Cillian Vallely born?	Armagh
Where was Alfred Darjou born?	Paris
Where was Medo Martinello born?	Windsor
Where was Georges Hanna Sabbagh born?	Alexandria
Where was David Lister born?	Grimsby
Where was Ely Devons born?	Bangor
Where was Kim Kuusi born?	Helsinki
Where was Marek Muszyński born?	Lublin
Where was Peter Gregg born?	Kent
Where was Robin Hofman born?	Rotterdam
Where was Rufus Phillips born?	Virginia
Where was John Wainwright born?	Australia
Where was Eugène Brieux born?	Paris
Where was Alexander Randall born?	Annapolis
Where was Hubert Buchberger born?	Frankfurt
Where was Margaret Gwenver born?	Wilmington
Where was Donald B. Cole born?	Lawrence
Where was Paul Pope born?	Philadelphia
Where was Rem Urasin born?	Kazan
Where was Franz Ludwig Catel born?	Berlin
Where was Samuel Löw Brill born?	Budapest
Where was Lene B%C3%B8rglum born?	Denmark
Where was Andrea Gallandi born?	Venice
Where was Thomas Elliot Bowman III born?	Brooklyn
Where was Thomas R. Fitzgerald born?	Chicago
Where was Thomas Taylor born?	London
Where was Peter Cooper born?	Salisbury
Where was Jimmy Greenspoon born?	California
Where was Alessio Secco born?	Turin
Where was Arnold Zable born?	Wellington
Where was Robert Bourne born?	London
Where was Edmund Fetting born?	Warsaw
Where was Johan Reuter born?	Copenhagen
Where was William Keasberry born?	London
Where was John Norton Pomeroy born?	Rochester
Where was Nadia Jebril born?	Sweden
Where was Ryan Burr born?	Pennsylvania
Where was Francesco Musotto born?	Palermo
Where was Martin Vari born?	Argentina
Where was Carlos Cosías born?	Barcelona
Where was Barrie Thorne born?	Utah
Where was Kate Richardson born?	Melbourne
Where was Hyman I. Goldstein born?	Baltimore
Where was Pierre Cartellier born?	Paris
Where was Lucius Vibullius Hipparchus born?	Athens
Where was Kemal Alispahić born?	Sarajevo
Where was Serge Collot born?	Paris
Where was Carl Strehl born?	Berlin
Where was Michael E. Driscoll born?	Syracuse
Where was J%C3%B8rgen Sigurd Lien born?	Bergen
Where was Debra A. Kemp born?	Highland
Where was Ralph Schoenman born?	Brooklyn
Where was Gerrard Wendell Haworth born?	Nebraska
Where was Marion Stein born?	Vienna
Where was Maurice Maunoury born?	Alexandria
Where was Valdo Spini born?	Florence
Where was Peter Stetina born?	Boulder
Where was Tim McGill born?	Chicago
Where was Michael Colgrass born?	Chicago
Where was Vlad Georgescu born?	Bucharest
Where was Neil Williams born?	Canada
Where was Diego Carranza born?	Mexico
Where was Augustus A. Bird born?	Vermont
Where was Gloria Mann born?	Philadelphia
Where was Orsamus B. Matteson born?	Verona
Where was Lars Jonsson born?	Gothenburg
Where was Abraham Garton born?	Spain
Where was Erik Dammann born?	Oslo
Where was Samuel S. Adams born?	Lincoln
Where was Laurent Boyer born?	Paris
Where was Michael Raedecker born?	Amsterdam
Where was Robin Gillett born?	London
Where was Gordon Coppuck born?	Fleet
Where was Marilyn Shrude born?	Chicago
Where was Regina Maršíková born?	Prague
Where was Stanley Sporkin born?	Philadelphia
Where was Juan Carlos González Zamora born?	Cuba
Where was Salvatore Sabella born?	Sicily
Where was Gosia Piotrowska born?	Poland
Where was Manola Saavedra born?	Spain
Where was John Owens born?	Manchester
Where was Barbara Strass born?	Vienna
Where was Jacques Benedict born?	Chicago
Where was %C3%81lvarez de Paz born?	Toledo
Where was Andrzej Kunert born?	Warsaw
Where was John Molyneux born?	Warrington
Where was Maggie Fitzgibbon born?	Melbourne
Where was Bruce Metcalf born?	Amherst
Where was Janet Ramsey Johnson born?	Adelaide
Where was Ien Ang born?	Java
